9 9 9 9 9 9 9 9 9 9
9 0 0 0 0 0 0 9 9 9 
9 0 1 0 0 0 0 9 9 9 
9 0 0 0 0 0 0 9 9 9 
9 0 2 0 0 2 0 9 9 9 
9 0 2 0 0 0 0 9 9 9
9 0 0 1 0 0 6 9 9 9
9 9 9 9 9 9 9 9 9 9
9 9 9 9 9 9 9 9 9 9
9 9 9 9 9 9 9 9 9 9