Best results:
{14 19 30 67 83 0 0 0 0 0 0}
{14 24 52 108 354 0 0 0 0 0 0}
{14 19 32 73 156 0 0 0 0 0 0}
{14 26 36 81 124 0 0 0 0 0 0}
{14 21 36 71 87 0 0 0 0 0 0}
{14 19 30 65 85 0 0 0 0 0 0}
{14 19 32 65 95 0 0 0 0 0 0}
