9 9 9 9 9 9 9 9 9 9
9 9 9 9 9 9 9 9 9 9
9 9 9 0 1 1 1 9 9 9
9 9 9 1 1 0 1 9 9 9
9 9 9 9 9 2 0 9 9 9
9 0 0 2 0 0 2 2 0 9
9 5 2 0 2 0 0 0 0 9
9 0 0 9 9 9 0 0 0 9
9 9 9 9 9 9 9 9 9 9
9 9 9 9 9 9 9 9 9 9
