9 9 9 9 9 9 9 9 9 9
9 0 0 0 1 0 0 0 0 9 
9 0 2 0 0 2 0 0 0 9 
9 0 0 0 0 0 0 0 1 9 
9 0 0 0 0 2 9 9 9 9 
9 1 0 0 2 0 0 9 9 9
9 9 9 0 0 0 0 1 0 9
9 0 2 0 9 0 0 0 6 9
9 0 0 0 0 9 9 9 9 9
9 9 9 9 9 9 9 9 9 9